1111111111111
10C10000000C1
1000011111011
1000110E000P1
1111111111111