1111111111111
11C00000000C1
1000011100011
1000110E100P1
1111111111111