1111111111111111111111111111111111
1E0000000000000C00000C000000000001
10100101001000001010P1000000010101
1010010010101010001001000000010101
100000000C00C0000000000000000000C1
1111111111111111111111111111111111
